記述をする	と	主体と
注目を集める	が	サポートベクターマシンが
経験を行う	にを	元に学習を
進化を見せる	てにおいては	活躍している敵対的生成ネットワークは加えて生成技術において
進化をいる	てにおいては	活躍している敵対的生成ネットワークは加えて生成技術において
開発を行う	は	エイダ・ラブレスは
意味をする	に	データに
研究を進める	て	費やして
命令をする	で	機構で
運転をする	に	元に
特許をする	がにまで	2018年までに日本が
特許をいる	がにまで	2018年までに日本が
運転をする	てに	基づいて柔軟に
注目を集める	からは	ことからファジィは
制御をする	から	少なさから
研究を続ける	がて	ジェフホーキンスが向けて
研究をいる	がて	ジェフホーキンスが向けて
注目を集める	に	急速に
投資を行う	でに	全世界的に民間企業主導で
探索を行う	で	無報酬で
推論をする	て	経て
研究を行う	て	始めており
研究をいる	て	始めており
投資をする	にはまで	韓国は2022年までに
反乱を起こす	てに対して	於いて人間に対して
監視を行う	にまで	歩行者まで人工知能に
監視をせる	にまで	歩行者まで人工知能に
判断を介す	から	観点から
禁止を求める	がには	4月にはヒューマン・ライツ・ウォッチが
禁止をいる	がには	4月にはヒューマン・ライツ・ウォッチが
追及を受ける	てでととともには	暴露されており公聴会ではとともに拒否すると整合性で
解任をする	ては	含まれておりGoogle社員らは
解散をする	がでは	Googleは倫理委員会が理由で
話をする	は	哲学者は
話をいる	は	哲学者は
議論を行う	まで	これまで
議論をくる	まで	これまで
